...###......#####....
..##.#.####...##..#..
.##..###.....####.#..
##........#.#.##..#..
#..#@#.#..#...###.#..
########..###.###....
..#.!#........####...
.##.##.#.####...##...
.#............###....
.......#####......#..
.############....##..
.....................