####################
#..................#
#...!..............#
#..................#
#..................#
#..................#
#..................#
#..................#
#..................#
#..................#
###########@########
           .