#@#...#...###........
#.#.#.#.#..##..####..
#.#.#.#.##..##..##...
#.#.#.#.###..#.###...
#.#.#.#.#...##..###..
#.#.#.#.#.###...##...
#.#.#.#.#..##...##.#.
#.#.#.#.#.##...###...
#.#.#.#.#..##...##...
#.#.#.#.##..#..###.#.
#...#...#.....####.!.
.....................