@##################!.
.###..............#..
..##...##....###.##..
#..###..###...##..#..
..##....#...#..##.#..
...####.###.....#.#..
##.#....####.##...#..
#..###.###...##.###..
..##...##..##....#...
#.##.##.#.##..##.....
......#......##..###.
.....................