###############......
..#@.#......#####....
.......####....####..
#####.......##.....#.
##.......#....###.##.
.....###....##.......
###.....###.....####.
....#.#.....##.###...
####..#.##...##..#.#.
!....###....###.#..#.
###.......#########..
.....................