########
#...!..#
#......#
#......#
#......#
####@###