##@###..
#..##..#
!.####..
#...#..#
..#.##.#
.......#